{
  "tiles" : [ [1, 0, 1, 1, 1, 1, 1, 0, 1 ],
              [1, 0, 1, 1, 1, 1, 1, 0, 1 ],
              [1, 0, 1, 1, 1, 1, 1, 0, 1 ],
              [1, 1, 1, 1, 1, 1, 1, 1, 1 ],
              [1, 1, 1, 1, 0, 1, 1, 1, 1 ],
              [1, 1, 1, 1, 1, 1, 1, 1, 1 ],
              [1, 0, 1, 1, 1, 1, 1, 0, 1 ],
              [1, 0, 1, 1, 1, 1, 1, 0, 1 ],
              [1, 0, 1, 1, 1, 1, 1, 0, 1 ] ],

  "targetScore" : 1200,
  "moves" : 12,
}
