{
  "tiles" : [ [0, 1, 0, 0, 0, 0, 0, 1, 0 ],
              [0, 1, 0, 0, 0, 0, 0, 1, 0 ],
              [0, 1, 0, 0, 0, 0, 0, 1, 0 ],
              [0, 0, 0, 0, 0, 0, 0, 0, 0 ],
              [0, 0, 0, 0, 1, 0, 0, 0, 0 ],
              [0, 0, 0, 0, 0, 0, 0, 0, 0 ],
              [0, 1, 0, 0, 0, 0, 0, 1, 0 ],
              [0, 1, 0, 0, 0, 0, 0, 1, 0 ],
              [0, 1, 0, 0, 0, 0, 0, 1, 0 ] ],

  "targetScore" : 1200,
  "moves" : 12,
}
